6 8
00000000
00000000
00001100
00001100
00011000
00010002
2 1 0