10 10
0001001020
0010000100
0010011000
0011011000
0010011000
1000010000
1101001000
0001000000
0100001100
0100100000
0 0 0
