10 10
1110000002
1100000000
1000000000
0000111000
0011000000
0000000000
0000000000
0000000000
0000000000
0000000000
0 0 0
